numerRachunku	dataOperacji	nazwaPodmiotu	opisOperacji	kwotaOperacji	saldoOperacji
PL80109024023367267123281484	2024-01-05	Januszex	Materiały budowlane	-3000.00	7000.00
PL80109024023367267123281484	2024-01-25	Mietex	Profile aluminiowe	-5000.00	2000.00
PL80109024023367267123281484	2024-02-02	Mietex	Płyty GK	-3000.00	-1000.00
PL80109024023367267123281484	2024-02-15	Jacek Jaworek	Robocizna Pruszków	5000.00	4000.00
PL80109024023367267123281484	2024-02-18	Donald T.	Robocizna Wawer	6000.00	10000.00
PL80109024023367267123281484	2024-02-20	Jarosław K.	Robocizna Żoliborz	10000.00	20000.00
PL31109024025715935234517169	2024-02-14	Waldex	Materiały budowlane	-10000.00	11370.00
